1111111111111111111111111111111
1..0........1.................1
1..P........1.................1
1..1111111..1..1111111111..1..1
1..1.....1.....1.....1.....1..1
1..1.....1.....1.....1..X..1..1
1..1..1..1..1111111..1..1111111
1..1..1..1..1........1........1
1..1..1..1..1........1........1
1..1..1..1..1..1111111111111..1
1.....1..1.....1........1.....1
1.....1..1.....1........1.....1
1111111..1111111..1111..1..1111
1..1..X..1........1.....1.....1
1..1.....1........1.....1.....1
1..1..1111..1111111..1111111..1
1.....1.....1..1.....1........1
1.....1.....1..1.....1........1
1..1111111..1..1..1111..1111..1
1........1..1..1........1..1..1
1........1..1..1........1..1..1
1111111..1..1..1111111111..1..1
1..1.....1..1..............1..1
1..1.....1..1..............1..1
1..1..1111..1..1111111..1..1..1
1..1........1..X..1..1..1..1..1
1..1........1.....1..1..1..1..1
1..1111111111111..1..1..1111..1
1....................1........1
1....................1........1
1111111111111111111111111111111