################################
#..............................#
#..............................#
#..............................#
#..............................#
#.......#####......#####.......#
#......./......X......./.......#
#......./............../.......#
#......./............../.......#
#......./............../.......#
#..............P...............#
#..............##..............#
#..............##..............#
#..............................#
#......./............../.......#
#......./............../.......#
#......./......0......./.......#
#......./............../.......#
#.......#####......#####.......#
#..............................#
#..............................#
#..............................#
#..............................#
################################