###############################################################
#.............................................................#
#.............................................................#
#..............P...........X..................................#
#.............................................................#
#.......#####......#####......................................#
#.......#..............#......................................#
#.......#..............#......................................#
#.......#..............#......................................#
#.......#.......0......#......................................#
#.............................................................#
#..............##.............................................#
#..............##.............................................#
#.............................................................#
#.......#..............#......................................#
#.......#..............#......................................#
#.......#..............#......................................#
#.......#..............#......................................#
#.......#####......#####......................................#
#.............................................................#
#.............................................................#
#.............................................................#
#.............................................................#
#.............................................................#
#.............................................................#
#.............................................................#
#.............................................................#
#.............................................................#
#.............................................................#
#..######..######..######..######..######..######..#########..#
#..#....#..#....#..#....#..#....#..#....#..#....#..#.......#..#
#..#....#..#....#..#....#..#....#..#....#..#....#..#.......#..#
#..#....#..#....#..#....#..#....#..#....#..#....#..#.......#..#
#..#....#..#....#..#....#..#....#..#....#..#....#..#.......#..#
#..#....#..#....#..#....#..#....#..#....#..#....#..#.......#..#
#..######..######..######..######..######..######..#########..#
#.............................................................#
#.............................................................#
#.............................................................#
#.............................................................#
#.............................................................#
#.............................................................#
#.............................................................#
#.............................................................#
#.............................................................#
#.............................................................#
#.............................................................#
###############################################################